1333233133333310
3333333313332333
3323133333323233
3333333033333333
1323333333333333
1333333330333333
3331333333330333
3333332313333333
2331331331333333
3333333333303333
3313311333333333
3333033333333003
3333223333333333
2303333333313333
3323333300333133
2303333333313333
1-0
7-14
A B C A B C
A B C

0000000000000000
0000000000000000
0000000000000000
0000000000000000
0000000000000000
0000000000000000
0000000000000000
0000000000000000
0000000000000000
0000000000000000
0000000000000000
0000000000000000
0000000000000000
0000000000000000
0000000000000000
0000000000000000
5-5
5-10
A A A A
	
0000000000000000
0000000000000000
0000000000000000
0000000000000000
0000000000000000
0000000000000000
0000000000000000
0000000000000000
0000000000000000
0000000000000000
0000000000000000
0000000000000000
0000000000000000
0000000000000000
0000000000000000
0000000000000000
5-5
5-10
B
B B B B