0333333333333333
3333333233333133
3313333333333333
3333303332333133
0313233223333333
3133333033333333
3333233333332333
3122333333323300
3330333333130000
3333113333301200
3233323332333331
1323333133333333
3333333333333133
3023133313333333
3333323333323333
3232303313321303
1-1
7-14
A A A A A A A A A A
A A A A A A A A A A
A A A A A A A A A A