0000000000X00000
0000000000100000
0000000000100000
0000000000100000
0000111111100000
0000100000000000
0000100000000000
0000100000000000
0000100000000000
0000100000000000
0000100000000000
0000100000000000
0000111111100000
0000000000100000
0000000000100000
0000000000100000
A B C A B C
A B C

0000000000X00000
0000000000100000
0000000000100000
0000000001100000
0000000001000000
0000000001000000
0000000001000000
0000000001000000
0000000001000000
0000000011000000
0000000010000000
0000000010000000
0000000011100000
0000000000100000
0000000000100000
0000000000100000
A A A A
	
000X000000000000
0001000000000000
0001000000000000
0001000000000000
0001000000000000
0001000000000000
0001000000000000
0001000000000000
0001000000000000
0001000000000000
0001000000000000
0001000000000000
0001000000000000
0001000000000000
0001000000000000
0001000000000000
B
B B B B