0333333333333333
3333333233333133
3313333333333333
3333303332333133
0313233223333333
3133333033333333
3333233333332333
3122333333323300
3330333333130000
3333113333301200
3233323332333331
1323333133333333
3333333333333133
3023133313333333
3333323333323333
3232303313321303
2-0
7-14
A A A A
B B
A A B A B A A
A A A A A A A A A A A

4454454544546555
5444544654646555
4444654544656645
4454456654565454
4465555465546445
5456555566565445
6464465466664544
5565556554656556
6466464655655665
4655454546666666
4656454445464454
4446446566446464
6454645545546555
4665664565555666
4654566455645546
4544666666545564
5-5
6-8
A A A A A
B A A A B
B B B B B
A B A B A B A B A